XXXXXXXXXXXXXXXXXXXXXXXXXXXXXXXXXXXXXXXX
XXX     XX     XXXXXXXXXXXXXXXXXXXXX EXX
XXXXXXXXXXXXXX XXX          XXXX     XXX
XX XX           XXX XXXXXXX XXXX XXXXXXX
XX XX XXXXXXXXX XX  XXXXXXXXXXXX XXXXXXX
XX XX XXXXXXX XXXXX XXXXXXX XXXX XXXXXXX
XX XX XXXX    XXXXX XXXXXX            XX
XX XX XXXX XX XXXXX   XXX XXXXXXXXX XXXX
XX XX XXXX XX XXXXXXX XXX     XXXX    XX
XX XX      XX     XXX XXXXXXX XXXX XX XX
XX XXXXXXXXXX XXX XXX XXXXXXX      XXXXX
XX      XXXXX XXX XXXXXX      XXXX XXXXX
XXXX XX XXXXX XXX XX     XXXX XXXX   XXX
XXXX XX XXXXX XXX XX XXXXXXXX XXXXXX XXX
XX   XX XXX   XXX XX XXXXX      XXXX XXX
XXXX XX     XXXXX    XXXXX XXXXXXX XXXXX
XXXX XXXXXXXXXXXXXXXXXXXXX XXXXXXX   XXX
XXXX                XXX        XXXXX XXX
XXXXXXXXXXXXXXXX XXXXXX XXXXXX XXXXX XXX
XXX              XXXXXX XXXXXX XXXXX XXX
XXX XXXXXXXXXXXXXXXXX   XX     XXXXX  XX
XXX             XX XX XXXX XXXXXXXXXX XX
XS  XXXXXXXX XXXXX    XXXX            XX
XXXXXXXXXXXXXXXXXXXXXXXXXXXXXXXXXXXXXXXX
